20;10
####################
    #######    #####
#              #   #
######### #####    #
##                 #
######### ###      #
#   ##### ##########
#                 ##
#   ##########      
####################